+-+-+-+-+-+-+-+-+-+-+-+-+
      |               | |
+ +-+ +-+-+-+-+ +-+-+ + +
| |           | |   |   |
+ +-+-+-+-+-+ + +-+ +-+ +
|     |     |   |   |   |
+-+-+ + + +-+-+-+ + + +-+
|   | | |         | | | |
+ + + + +-+-+-+ +-+-+ + +
| |   |       |   |   | |
+ +-+-+-+ +-+-+-+ + +-+ +
|     |   |     | | |   |
+-+-+ + +-+ +-+ + + +-+ +
|   | |   |   | | |     |
+-+ + +-+ + +-+ + +-+-+ +
|   | |   | |   |   |   |
+ +-+ +-+-+ + +-+ +-+ +-+
| |   |     | |       | |
+ + + + +-+-+-+ +-+-+-+ +
| | | | |     |         |
+ + +-+ +-+ +-+-+-+-+-+ +
| |     |   |     |   | |
+ +-+-+-+ +-+ + +-+ + + +
|             |     |    
+-+-+-+-+-+-+-+-+-+-+-+-+

+-+-+-+-+-+-+-+-+-+-+-+-+
######|        #######| |
+\+-+#+-+-+-+-+#+-+-+#+ +
|\|  #########|#|\\\|###|
+\+-+-+-+-+-+#+#+-+\+-+#+
|\\\\\|\\\\\|###|\\\|###|
+-+-+\+\+\+-+-+-+\+\+#+-+
|\\\|\|\|\\\\\\\\\|\|#| |
+\+\+\+\+-+-+-+\+-+-+#+ +
|\|\\\|\\\\\\\|\\\|###| |
+\+-+-+-+\+-+-+-+\+#+-+ +
|\\\\\|\\\|\\\\\|\|#|   |
+-+-+\+\+-+\+-+\+\+#+-+ +
|   |\|\\\|\\\|\|\|#####|
+-+ +\+-+\+\+-+\+\+-+-+#+
|   |\|\\\|\|\\\|\\\|###|
+ +-+\+-+-+\+\+-+\+-+#+-+
| |\\\|\\\\\|\|#######| |
+ +\+\+\+-+-+-+#+-+-+-+ +
| |\|\|\|     |#########|
+ +\+-+\+-+ +-+-+-+-+-+#+
| |\\\\\|   |     |   |#|
+ +-+-+-+ +-+ + +-+ + +#+
|             |     |  ##
+-+-+-+-+-+-+-+-+-+-+-+-+
